1111111111111
10010000001C1
1000011111011
1PC0110000001
1000000CE0001
100C000000001
1111111111111